O1.....E...O...V
.O............V.
..O...O..V...V..
.V.O.O.OV.V.V...
..V.O.O..V.V....
...V.O.OV.V....V
....O.O..V....V.
V..O...OV....V.2
.VO....VO...V.O.
..V...V..O.V.O.O
.O.V.V....O.O.O.
O...VV.....O.O.O
.O.V..V.....O.O.
..V....V.....O.O
OV.....@#.....O3