1...............
.######.######..
.#...........##.
.#...#####...#..
.#.......O...##.
.#.#.##.##.#.#..
.#.#.#...#.#.##.
.#.#...@...#.#2.
V#.#.#...#.#.##.
.#.#.##.##.#.#..
.#...........##.
.#.O.#####...#..
.#...........##.
.######.######..
...3...........E
