O1.....E...O...V
.O............V.
..O..........V..
.V.O........V...
..V.O......V....
...V.O....V....V
....O.O..V....V.
V..O...OV....V.2
.VO....VO...V...
..V...V..O.V....
...V.V....O.....
O...V......O....
...V........O...
..V....V.....O..
OV.....@#.....O3