V.OV....V#V....E
.##.#O...#.##V..
..#.####.#..##..
....V#1..#..V##.
####.##O...#.#O.
VO.V.#####.#.##.
.##.##V....#..O.
.##.##.#...#####
.##.##..V....V.V
.##..O.#...O....
.V..##.#.####.#.
#...#2...##3.O..
O.######.##.##..
#.####O...#V..O.
@......#O...#..#