E....O1##2.....O
....V##.3##V....
...V#O.V...#....
O..#........#...
..O#........#O..
.V##O.....V.##V.
.#.####.V####.#.
.#..........O.#.
.#O...........#.
..####....####..
.O
....#...#...#
...O#...#.O.#
V..#...V#...V#
...............@