1........O......
....########2#..
...#.#......#E..
..#.........@#..
..#........#.#..
.#..#..#......#.
.#..#O.#......#.
.#...........O#.
.#.V..........#.
.#..V.........#.
..#..#V##.#..#..
..#..#.##V#..#..
..##.#.##.#V##..
V....O..........
3O.............V