2..............O
.######.######..
.#..........O##.
.#O..#####.O.#..
.#.......O...##.
.#.#.##.##.#.#.O
.#.#.#...#.#.##.
.#.#...@...#.#1.
.#.#.#...#.#.##.
.#.#.##.##.#.#..
.#.....O.....##.
.#.O.#####..O#O.
.#..O........##.
.######.######..
...3..........OE
