2..............O
.######.######..
.#..........O##.
.#O..#####.O.#.V
.#.......O...##.
.#.#.##.##.#.#.O
.#.#.#...#.#.##.
.#.#...@...#.#1.
V#.#.#...#.#.##.
.#.#.##.##.#.#..
.#.....O.....##.
.#.O.#####..O#O.
.#..O........##.
.######.######..
...3..........OE
