2..............O
.######.######..
.#..........O##.
.#...#####...#..
.#.......O...##.
.#.#.##.##.#.#..
.#.#.#...#.#.##.
.#.#...@...#.#1.
.#.#.#...#.#.##.
.#.#.##.##.#.#..
.#.....O.....##.
.#...#####...#..
.#..O........##.
.######.######..
...3..........OE
